#A sol
#B herbe
AAABBAAABBAAAAAAAAAAAAAAA
AAAAAAAAAAAAAAAAAAAAAAAAA
AAABAAAAAAAAAAABBAAAAABBB
AAAAABBAAAAABBAAAAABAAAAA
AAAAAAAAAAAAAAAAAAAAAAAAA
AAABBAAABBAAAAAAAAAAAAAAA
AAAAAAAAAAAAAAAAAAAAAAAAA
AAABAAAAAAAAAAABBAAAAABBB
AAAAABBAAAAABBAAAAABAAAAA
AAAAAAAAAAAAAAAAAAAAAAAAA
AAABBAAABBAAAAAAAAAAAAAAA
AAAAAAAAAAAAAAAAAAAAAAAAA
AAABAAAAAAAAAAABBAAAAABBB
AAAAABBAAAAABBAAAAABAAAAA
AAAAAAAAAAAAAAAAAAAAAAAAA

