#A sol
#B herbe
#C arbre hg
#D arbre hd
#E arbre mg
#F arbre md
#H arbre bg
#I arbre bd
#J passage g
#K passage d
BBBBBBBBBBBBBBBBBBBBBBBBB
BAAAAAAAAAAACDAAAAAAAAAAB
BAABAAAAAAAAEFABBAAAAABBB
BAAAABBAAAAAHIAAAAABAAAAB
BAAAAAAAAAAAAAAAAAAAAAAAB
BAABBAAABBAAAAABAAAAAAAAB
BAAAAAAAAAAAAAAAAAAAAAAAB
BAABAAAAAAAAAAABBAAAAABBB
BAAAABBAAAAABBAAAAABAAAAB
BAAAAAAAAAAAAAAAJKAAAAAAB
BAABBAAABBAAAAAAAAAAAAAAB
BAACDAAAABBAAAAAAAAAAAAAB
BAAEFAAAAAAAAAABBAAAAABBB
BAAHIBBAAAAABBAAAAABAAAAB
BBBBBBBBBBBBBBBBBBBBBBBBB

